ka kha 	alphabet
ka khol 	pillar-hole
ka tshigs chen mo 	Ka chigs čhen mo, title of a historiographical work
ka bzhi gdung brgyad ma 	(PN) Ka-bźi-gduṅ-brgyad-ma
kun 	1) (N) all, everyone; 2) (A) all
kun mkhyen 	the Omniscent One
kun dga' bo 	(PN) Kun-dgaɣ-bo (Skt. Ānanda)
kun dga' ra ba 	copse, park
kun tu 	1) all around; 2) through
kun tu bzang po 	(PN) Kun-tu-bzaṅ-po (Skt. Samantabhadra)
kun nas 	perfectly
kun nas dga' ba 	surpassingly lovely
ker 	(TR) to raise
ko ba 	hide
ko sa la 	(PN) Ko-sa-la (Skt. Kośala)
kong po 	(PN) Koṅ-po, a historical region in Tibet
kyi hud 	(Intrj) Oh!
kye 	(Intrj) Oh! Alas!
kye ma 	(Intrj) Oh! Alas!
klad kor 	zero
klu rgyal 	(PN) Klu-rgyal
klu brgyad mkhan 	(PN) Klu-brgyad-mkhan
klu dbang 	lord of serpents
klu mo 	serpent demoness (Skt. nāgī)
klung 	river valley
klog  v2 {bklags} v3 {bklag} v4 {lhogs}	(TR) to read
dka' ba 	(to be) difficult
dkar nag 	friendly or unfriendly, lit. “white or black”
dkar po 	white
dkar ba 	(to be) loyal
dkar mi 	loyal person
dkar mo 	white
dkar yol 	porcelain cup
dkyil 'khor 	circle, disc
bka' 	(HON) order
bka' grims 	(OT; HON for {khrims}) sovereign law
bka' chems 	(HON for {chems}) testament
bka' chems ka khol ma 	Bkaɣ čhems ka khol ma, title of a historiographical work
bka' drin 	(HON for {drin}) kindness
bkal 	see 'gel 
bkur 	see 'khur 
bkra mi shis 	misfortune, mischief
bkres 	(to be) hungry
bkrongs 	see 'grong 
bkrol 	see 'grol 
bklags 	see klog 
rkang pa 	leg, foot
rkang mig 	(PN) Rkaṅ-mig (Skt. Akṣapāda)
rku  v2 {brkus} v3 {brku} v4 {rkus}	(TR) to steal
rko  v2 {brkos} v3 {brko} v4 {rkos}	(TR) to dig (out)
rkos 	see rko 
rkyang 	single
rkyal pa 	leather bag
rkyen 	cause
rkyen gyis 	(Postp) due to, because of (+ GEN)
lkog tu 	secretly
lkog lab 	slander
lkog lab tu 	slanderously
ska rags 	girdle
skad 	1) voice; 2) words
skad cig 	a moment
skar ma 	constellation
skal ba 	fortune
sku 	(HON for {lus}) body
sku mkhar 	(HON for {mkhar}) fortified castle
sku thim 	(HON for {thim}; INTR) to disappear
sku tshe 	(HON for {tshe}) lifetime
skur  v2/v3 {bskur} v4 {skur}	(TR) 1) to send; 2) to give
skul  v2/v3 {bskul}	(TR) to exhort
skong chu lag 	arm(s) of the Skoṅ-čhu river
skom 	1) (to be) thirsty; 2) (N) thirst
skom tshugs 	chin
skor  v2/v3 {bskor} v4 {skor}	(TR) 1) to surround; to besiege (+ DAT); 2) to turn; 3) to set in motion, to brandish
skya 	(to be) 1) pale; 2) flavourless
skya bo 	pale
skyabs 	protection
skyabs seng 	(PN) Skyabs-seṅ (Skt. Pāṇḍu)
skyi shod 	(PN) Skyi-śod, name of a region
skyid sdug 	happiness and misery
skyid po 	happiness
skyur  v2/v3 {bskyur}	(TR) to throw away
skye  v2 {skyes}	(INTR) 1) to be born; 2) to grow
skye ba 	1) birth; 2) life
skye bo 	man, human being
skyed  v2/v3 {bskyed}	(TR) to increase, to generate
skyen pa 	(A) precipitate
skyel  v2/v3 {bskyal} v4 {skyol}	(TR) to conduct, to bring
skyes 	see skye 
skyes pa 	man, male person
skyes bu 	living being
skyes bu chen po 	great person (Skt. mahāpuruṣa)
skyo 	(INTR) to be vexed (with +DAT)
skyong  v2 {bskyangs} v3 {bskyang} v4 {skyongs}	(TR) 1) to guard; 2) to tend
skyon 	1) fault; harm; 2) misdeed
skyob  v2 {bskyabs} v3 {bskyab} v4 {skyobs}	(TR) to protect, to guard; to save
skra 	hair
skrag dngang  v2 {skrag dngangs}	(INTR) to be terrified, frightened
skrag dngangs 	see skrag dngang 
skri  v2 {bskris} v3 {bskri} v4 {skris}	(TR) to charge, to assign
bskal pa 	aeon
bskur 	see skur 
bskul 	see skul 
bskor 	see skor 
bskyang 	see skyong 
bskyab 	see skyob 
bskyabs 	see skyob 
bskyal 	see skyel 
bskyur 	see skyur 
bskyed 	see skyed 
bskri 	see skri 

kha 	1) mouth; 2) surface
kha chems 	testament
kha dog 	colour
kha mdog 	complexion
kha na 	(Postp) on (+ GEN)
kha spu 	beard
kha ba 	snow
kha ba can 	1) (A) snowy (lit. possessing snow), snow-clad; 2) (N) Tibet
kha 'dzin 	assistant
kha zas 	food
kha rog pa 	silent
khang ({pa})	house
khang bu  	1) little house; 2) room
khab 	residence
khab len rdo 	lodestone
khams 	see 'khams 
khams chen po brgyad 	(PN) Khams čhen po brgyad, title of a Bon-po work
khams pa 	(A) faint
khams bzang 	good health
khar 	(Postp) on, upon, after; in addition to (+ GEN / ABS)
khal 	burden, load
khung 	hole
khung bu 	hole
khe spog 	profit
khengs 	see 'khengs 
kho 	(3SG M) he
kho thag 	see chod 
kho pa 	(3SG M) he
kho bo 	(1SG M) I
kho ma 	(3SG F) she
kho mo 	(1SG F) I
kho rang 	(3SG M) he, himself
khog che 	of great intrinsic power
khong 	(3SG HON) he, she
khong mdzangs 	inner knowledge
khong seng 	inner cavern
khwa ta 	crow
khyad 	difference
khyad par 	difference
khyad par ({du})	in particular
khyab 	(INTR) to be comprised (by + ERG)
khyi 	dog
khyi mo 	bitch
khyi ro 	dog-cadaver
khyim 	house
khyim thab 	house and hearth
khyim bdag 	householder
khyim mtshes 	neighbour
khyim so 	household
khyu 	flock
khyung tsha dpal 'dren 	(PN) Khyuṅ-cha-dpal-ɣdren
khyed 	(2SG / PL; HON) you
khye'u 	boy
khyer 	see 'khyer 
khyo 	husband, man
khyo bzang 	good husband
khyod 	(2SG / PL) you
khra 	falcon
khrag 	blood
khrag khrug 	complicate, confused
khri 	ten thousand
khri 	1) throne; 2) (PN) name of a Tibetan dynasty
khri dgra dpung btsan 	(PN) Khri-dgra-dpuṅ-bcan
khri snyan gzugs btsan 	(PN) Khri-sñan-gzugs-bcan
khri de thog btsan 	(PN) Khri-de-thog-bcan
khri btsan nam 	(PN) Khri-bcan-nam
khri brtsigs 'bum brdugs 	(PN) Khri-brcigs-ɣbum-brdugs
khrid 	(TR) to lead, conduct
khrims 	law
khre log 	1) (INTR) to roll one’s self; 2) (N) a rolling
khre log log 	an incessant continuous rolling
khro  v2 {khros}	1) (to be) angry, wrathful; 2) (N) rage
khro gnyer can 	(PN) Khro-gñer-čan (Skt. Bhṛkuṭī)
khros 	see khro 
mkha' lding 	see nam mkha' lding 
mkhar 	castle
mkhas pa 	1) skilled (in + DAT), wise, learned; 2) wise one
mkhas po  	a skilled male person; a scholar
mkhyen 	(HON for {shes}; TR) 1) to recognise, to discern, to realise; 2) to understand, to know
'khams  v2 {khams}	(INTR) to faint away
'khar ba 	staff
'khal  v2/v3 {bkal} v4 {khol}	(TR) to spin
'khur  v2 {bkur}	(TR) to carry
'khengs  v2 {khengs}	(INTR) to be full
'khor 	1) (INTR) 1) to turn round; 2) to circle; 2) (N) retinue, attendants
'khor ba 	cycle of transmigration / existence (Skt. saṃsāra)
'khor lo 	wheel
'khor los sgyur 	universal emperor
'khol  v2/v3 {bkol} v4 {khol}	(TR) to appoint, to use
'khyer  v2 {khyer}	(TR) to carry, to carry away
'khrug  v2 {'khrugs}	(INTR) to be disturbed
'khrug dus 	time for a duel
'khrung  v2 {'khrungs}	(HON for {skye}; INTR) to be born; {sku 'khrung} (HON) to be born
'khrungs 	see 'khrung 

ga re 	Where is \he / she / it\?
ga la 	(INT) to / for whom? where?
gang 	(INT) who? what? which?
gang 	(to be) full
gang ltar na yang 	be that as it may
gang du 	(INT) where? wither?
gang na 	(INT) where?
gang na ba 	whereabouts; lit. the where-place
gang nas 	where from?
gang ba 	full
gang yang 	any(thing), whatsoever
gangs 	snow-mountain
gangs dkar 	white snow-mountain
gangs can 	Tibet
gangs ri sog kha 	(PN) Gaṅs-ri-sog-kha
gad mo 	laugh
gar 	(INT) whither?
gal te 	if
gal te na 	perhaps
gu ru legs 	(PN) Gu-ru-legs
gum 	see 'gum 
gur 	tent
gus pa 	reverence
go 	place, spot
go 	(TR) to understand
go chod 	capable
go ba 	understanding
gong 	the above
gong na 	(Postp) before (+ GEN)
gong po 	clod
gong ma 	previous one
gon 	(TR) to put on
gos 	cloth, clothes
gos thung 	trousers
gos dar 	silk cloth(es)
gos ser can 	(PN) Gos-ser-čan, lit. dressed in yellow clothes, an epithet of Viṣṇu (Skt. pītāmbara)
gos hrul 	tattered robe
gau ta ma 	(PN) Gautama, the name of the Buddha (Skt. Gautama)
gyang 	pisé
gyis 	see bgyid 
gyur 	see 'gyur 
gyes 	see 'gye 
gyon 	(TR) to wear
gyos po 	father-in-law
grags 	see 'grags 
grangs med ({pa})	innumerable
gral 	place in the row
gral pa 	person sitting in a row
gri gum btsan po 	(PN) Gri-gum-bcan-po
gru gu 	(PN) Gru-gu, i.e. Western Turks
gru gsum 	triangular
grung 	(to be) wise
grung zhan 	weak-minded person
grub 	see 'grub 
grub pa 	accomplished one
gro 	wheat
grog mkhar ba 	(PN) Grog-mkhar-ba (Skt. Vālmīki)
grog ma 	ant
grogs 	friend, companion
grogs po  	a male friend
grogs mo  	female friend
grong khyer 	village, town
grong chog 	village rituals
grongs 	see 'grong 
gros nyes 	bad counsel
grwa 	1) corner; 2) school
gla rtsi 	musk
glang 	ox
glang chen 	elephant
glang po che 	elephant
glang bu 	calf
glang dmar 	red ox
glad 	head
gling 	island
glen pa 	(to be) stupid
dga' 	(TR) 1) to rejoice in, to be happy / delighted about (+ DAT); 2) to like
dga' ldan 	(PN) Dgaɣ-ldan heaven (Skt. Tuṣita)
dga' bshes 	spiritual advisor, < *{dga' ba'i bshes nyen} (Skt. kalyāṇamitra) friend to virtue, spiritual advisor
dgas 	(INTR) to be cracked
dgu 	nine
dgung 	sky
dgun 	winter
dgum 	see 'gums 
dge bsnyen 	lay practitioner
dge ba 	1) virtuous deed, virtue; 2) (to be) virtuous
dge legs 	prosperity
dge slong 	monk
dgongs 	(HON for {sems}; TR) to think, to reflect (on + DAT)
dgod 	(INTR) to laugh; {gad mo dgod} to laugh
dgon pa 	hermitage
dgon pa pa  	hermit
dgos 	(TR) to need; (MOD) to be necessary, have to, need
dgra 	enemy
dgra bcom pa 	Arhat (Skt. arhant)
dgra bo 	enemy
dgra lha 	one of tutelary deities
bgegs 	difficulty
bgo  v2 {bgos}	(TR) to put on
bgo ba 	clothes
bgod  v2/v4 {bgos} v3 {bgo}	(TR) to divide
bgos 	see bgo 
bgos 	see bgod 
bgyi 	see bgyid 
bgyid  v2 {bgyis} v3 {bgyi} v4 {gyis}	(HML for {byed}; TR) 1) to do; 2) to say; {mchod pa bgyid} to make offerings; {so nam bgyid} to cultivate fields
bgyis 	see bgyid 
bgrang  v2 {bgrangs} v3 {bgrang}	(TR) 1) to count; 2) to reckon, to consider
bgres pa 	(N) elder man; (A) elder
bgro  v2 {bgros}	(INTR) to confer, to discuss
mgul 	neck
mgo ({bo}){}	head
mgon po 	patron, protector
mgon med zas sbyin 	(PN) Mgon-med-zas-sbyin (Skt. Anāthapiṇḍada)
mgyogs 	(to be) quick
mgyogs po 	quick
'ga' 	a few, some
'gal 	(TR) to contradict (+ COM)
'gum  v2 {gum}	(INTR) to die
'gums  v2 {bkum} v3 {dgum} v4 {khums}	(TR) to kill
'gul 	(INTR) to quiver
'gems 	(TR) to rip, to destroy
'gel  v2 {bkal} v3 {dgal} v4 {khol}	(TR) to carry
'god  v2 {bkod} v3 {dgod} v4 {khod}	(TR) to furnish
'gor ti 	(PN) Ɣgor-ti, place name
'gyur  v2 {gyur}	(INTR) 1) to become; 2) to happen
'gye  v2 {gyes}	(INTR) to split
'gyel  v2 {gyel}	(INTR) to collapse, to fall
'grags  v2 {grags}	(INTR) to be called; to be known as (+ TERM)
'gran sems 	quarrelsome temper
'gram 	shore; side
'grub  v2 {grub}	(INTR) to complete
'gre 	(INTR) to roll one’s self
'gro  v2/v4 {song}	(INTR) 1) to go; 2) to pass (of time); 3) to become (+ TERM)
'gro ba 	1) a being; 2) existence
'grogs 	(INTR) to come together, to be accompanied (by + COM)
'grong  v2 {grongs}	(HON for {'chi}; INTR) to die
'grong  v2 {bkrongs} v3 {dgrongs}	(HON for {gsod}; TR) to kill
'grol  v2 {bkrol} v3 {dgrol} v4 {khrol} 	(TR) to untie
rgan po 	old man
rgan mo 	1) old woman; 2) old
rgal  v2/v3 {brgal} v4 {rgol}	(TR) to cross (+ DEL)
rgud 	(INTR) to grow weak, to decline
rgod 	vulture
rgod ma 	mare
rgol  v2/v3 {brgal} v4 {rgol}	(TR) to fight (against + DAT)
rgya 	(PN) China
rgya gar 	(PN) India
rgya gar skad 	Sanskrit, lit. “language of India”
rgya nag 	(PN) China
rgya mtsho 	ocean
rgyags 	provisions
rgyang ma 	distance
rgyang tshad 	(N) a while
rgan gzhon 	age
rgyab 	(N) the back
rgyab  v2/v3 {brgyab} v4 {rgyob}	(TR) to throw
rgyal 	(INTR) to be victorious (over + DEL)
rgyal khams 	kingdom, realm
rgyal po 	king
rgyal phran 	vassal
rgyal bu 	prince
rgyal byed 	(PN) Rgyal-byed (Skt. Jetṛ)
rgyal blon 	king and minister
rgyal mo 	queen
rgyal rabs dpag bsam ljon shing 	Rgyal rabs dpag bsam lǰon śiṅ, title of a historiographical work
rgyal sa 	throne
rgyal srid 	1) government, reign; 2) dominion
rgyas 	(INTR) 1) to increase, to grow, to spread; 2) to be full of
rgyas pa 	(PN) Rgyas-pa (Skt. Vyāsa)
rgyas par 	in detail; expandingly, extensively
rgyu skar 	star
rgyug  v2 {brgyugs} v3 {brgyug}	(INTR) to run
rgyud 	1) realm of existence; 2) tantra
rgyun 	flow, stream
rgyun chad 	interruption
rgyun du 	constantly, continually
rgyus yod 	familiar with; lit. having knowledge (of)
sgo 	door
sgo  v2 {bsgo}	(TR) to say
sgo khyi 	door-guarding dog
sgo nas 	(Postp) 1) due to; 2) by means of (+ GEN)
sgom  v2 {bsgoms} v3 {bsgom} v4 {sgom}({sa}){}	(TR) to meditate
sgyu ma lha mdzes 	(PN) Sgyu-ma-lha-mȷes ({sgyu ma} = Skt. māyā, {lha mdzes} = Skt. devī)
sgyur  v2/v3 {bsgyur} v4 {sgyur} 	(TR) to translate
sgra 	sound; voice
sgra chen po 	(PN) Sgra-čhen-po
sgrig  v2 {bsgrigs} v3 {bsgrig} v4 {sgrigs}	(TR) to arrange
sgrub  v2 {bsgrubs} v3 {bsgrub} v4 {sgrubs}	(TR) to accomplish, to achieve
sgrog  v2 {bsgrags} v3 {bsgrag} v4 {sgrogs}	(TR) to promulgate
sgrom 	box, chest
sgrol  v2/v3 {bsgral} v4 {sgrol}	(TR) to rescue
sgrol ma 	(PN) Sgrol-ma (Skt. Tārā)
brgal 	see rgal 
brgya 	hundred
brgya dang bcu gcig 	hundred and eleven
brgya dang nyi shu 	hundred and twenty
brgyad 	eight
brgyad pa 	eighth
brgyab 	see rgyab 
brgyal 	(INTR) to faint away
brgyud 	lineage
bsgo 	see sgo 
bsgo  v2 {bsgos}	(TR) to soil, to stain
bsgom 	see sgom 
bsgoms 	see sgom 
bsgos 	see bsgo 
bsgrags 	see sgrog 
bsgrigs 	see sgrig 
bsgrub 	see sgrub 
bsgrubs 	see sgrub 

nga 	(1SG) I
nga rang 	(1SG) I
ngag 	speech
ngag tu 	verbally
ngang rgyud 	forbearance
ngang pa 	goose
ngan pa 	(to be) bad; wicked
ngan bu 	(1SG) I; humble I
ngar pa 	leg (of trousers)
ngal 	weariness
ngal 	(INTR) to be tired; {lus ngal} to be tired
ngu  v2 {ngus}	(INTR) to weep
ngur smrig 	yellowish red
ngus 	see ngu 
nged 	(1PL) we
nged rang 	(1PL) we
nges 	(to be) certain
nges par 	certainly
nges 'byung 	renunciation
ngo 	face
ngo tsha 	1) shame; 2) shameful
ngo mtshar 	1) miracle, wonder; 2) wonderful
ngom  v2 {ngoms}	(INTR) to be sated (by + ERG)
dngul 	silver
dngul rdo 	silver-ore
dngos po 	thing
mnga' 	(HON for {yod}; COP) to have
mngon par 	openly, visibly
mngon par sangs rgya  v2 {rgyas}	(INTR) to achieve manifesting enlightenment
mngon blo 	real understanding
rnga 	drum
rnga  v2 {brngas} v3 {brnga} v4 {rngos} 	(TR) to reap
lnga 	five
lnga brgya 	five hundred
lnga tshigs 	third out of five
snga 	earlier time
snga ba 	the earliest one
snga ma 	before
snga rol 	past ages
sngag  v2 {bsngags} v3 {bsngag} v4 {sngog}({sa}){}	(TR) to praise
sngags 	mantra
sngar 	1) (A) 1) earlier; 2) before, ahead; 2) (N) the past
sngar phan 	until recently
sngas mgo 	pillow
sngo 	green
sngon 	earlier
brnga 	see rnga 
bsngags 	see sngag 

cang 	any, any thing, anyone
ci 	(INT) what? (REL) which
ci ltar 	(INT) how? (REL) how (also {ji ltar})
ci 'dra 	(INT / REL) how; (REL) whatever
ci tsam 	(INT) how much?; (REL) so much
ci'i phyir 	(INT) why?
cung zad 	a little, a bit
gcags 	(INTR) to love
gcad 	see gcod 
gcig 	one
gcig tu na 	firstly
gcig pa 	(A) only
gcig pu 	1) sole; 2) alone
gcig po 	(A) only
gcog  v2 {bcag} v3 {gcag} v4 {chog}({sa}){}	(TR) to break; to knock out
gcod  v2 {bcad} v3 {gcad} v4 {chod}	(TR) 1) to cut; 2) to decide; {zhal che gcod} to pass a judgement
bcag 	see gcog 
bcas 	accompanied by, possessed of, together with (+ COM)
bcas 	see 'cha' 
bcings 	see 'ching 
bcu 	ten
bcug 	see 'jug 
bco brgyad 	eighteen
bco lnga 	fifteen
bcom 	see 'joms 
bcom ldan 'das 	the Victorious One (Skt. bhagavant), an epithet of Buddha
bcol 	see 'chol 
bcol gtams 	trust
bcos 	see 'chos 
bcos ma 	artificial
lcag 	a blow, a hit
lcags 	iron
lcags rdo 	iron-stone
lcags phye 	iron filing
lce 	tongue
lcogs 	(INTR) to be possible

cha 	part
cha lugs 	appearance
cha shas 	portion
chag 	see 'chag 
chags 	(INTR) to be attached (to + DAT)
chags 	(INTR) to arise
chags pa 	1) love; 2) passion
chang 	beer
chang tshong 	tavern
chang tshong ma 	beer-seller (F)
chad 	see 'chad 
chad pa 	begotten / born from (+ DEL)
chab srid 	dominion
char 'dod bye 'u 	cātaka-nestling
chas 	1) garment, clothes; 2) form, appearance
chibs  	(HON for {rta}) horse
chibs kha 	briddle
chu 	1) water; 2) river
chu klung 	river
chu sdor 	meat
chu bo 	river
chug 	see 'jug 
chung 	(to be) small, young
chung ngu 	1) (N) 1) the youngest; 2) childhood; 2) (A) small
chung gnyen 	child-marriage
chung ma 	wife
chung shos 	the youngest
chud gsan 	(TR) to waste
che ba 	(to be) great; {tshabs che ba} very great
chen po 	1) great; 2) big, large, vast
cho nges 	lamentation
chog 	see gcog 
chog 	(MOD) to be allowed, permitted
chod 	(INTR) to be decided; {kho thag chod} to be certain
chod 	see gcod 
chos 	1) Buddhist teaching, Dharma (Skt. dharma); 2) religious teaching; 3) thing, being, anything that exists
chos gos 	monk-robe
chos rgyal 	Dharma-king
chos pa 	follower of Dharma
chos 'byung 	lit. origins of Buddhism; name of a literary genre
mchi 	(HML; TR) to speak
mchi  v2 {mchis}	(HML for {'ong} / {'gro}; INTR) 1) to come; 2) to go
mchi ma 	tears
mchims bza' 	lady from the Mčhims family
mchis 	see mchi 
mchis 	(HML for {yod}) to be there
mched 	(HON) brother
mchog 	the most excellent
mchog tu  	very
mchong({sa}){}	(INTR) to jump
mchod 	(TR) to worship
mchod rten 	shrine (Skt. stūpa)
mchod pa 	1) offering; 2) honours
'chag 	(INTR) to walk
'chag  v2 {chag}	(INTR) to break
'chad  v2 {chad}	(INTR) 1) to be cut (off; into pieces); 2) to be separated; 3) to be decided / determined
'chad  v2/v3 {bshad} v4 {shod}	(TR) 1) to explain; 2) to relate
'cham 	(TR) to agree (upon + DAT); {kha 'cham} to agree
'cha'  v2 {bcas} v3 {bca'} v4 {chos}	(TR) to place (on + DAT)
'char  v2 {shar}	(INTR) to rise
'char byed 	(PN) Ɣčhar-byed (Skt. Udayana)
'chi  v2 {shi}	(INTR) to die
'ching  v2 {bcings} v3 {bcing} v4 {chings}	(TR) to bind
'chor  v2 {shor}	(INTR) to get lost, to perish; {mchi ma 'chor} (TR / NC) to shed tears
'chol  v2/v3 {bcol} 	(TR) 1) to appoint, to make; 2) to entrust (to + DAT)
'chos  v2 {bcos} v3 {bco} v4 {chos}	(TR) to make, to prepare

ji 	see ci 
ji ltar 	see ci ltar 
jo bo 	lord, master
jo mo 	1) goddess; 2) lady
mjug 	hind part
mjug ma 	tail
'jang 	(PN) name of an ancient people
'jam 	(to be) soft
'jam pa 	mild, gentle
'jam dpal gzhon nur gyur pa 	(PN) Ɣǰam-dpal-gźon-nur-gyur-pa, lit. Mañjuśrī who became a youth (Skt. Kumārabhūtamañjuśrī)
'ja' 	rainbow
'ja' tshon 	rainbow
'jal  v2 {bcal} v3 {gzhal} v4 {'jol}	(TR) to measure out
'jig  v2 {zhig}	to perish
'jig  v2 {bshig} v3 {gzhig} v4 {shig}	(TR) to waste, to annihilate
'jig rten 	world
'jig rten pa 	folk, inhabitants of the world
'jig pa 	decay
'jigs 	(INTR) to fear
'ju  v2 {'jus}	(TR) 1) to seize, to grasp; 2) to embrace
'ju  v2 {bzhus} v3 {bzhu}	(TR) to melt
'jug  v2 {zhugs}	(INTR) to enter
'jug  v2 {bcug} v3 {gzhug} v4 {chug}	(TR) 1) to put into; 2) to lead to; 3) to order; (CAUS) to cause, to let
'jus 	see 'ju 
'jog  v2 {bzhag} v3 {gzhag} v4 {zhog}	(TR) 1) to leave, to leave behind; 2) to lay down
'joms  v2 {bcom} v3 {gzhom} v4 {chom}	(TR) to conquer
rje 	lord, ruler
rjes 	1) (N) step, trace; 2) (Postp) after, behind (+ ABS)
rjes su 	(Postp) after (+ GEN); see rang 
rjod  v2/v3 {brjod}	(TR) to say

nya khri 	(PN) Ña-khri
nyag 	lump
nyang chu skya mo 	(PN) Ñaṅ-čhu-skya-mo, name of a river
nyang po 	(PN) Ñaṅ-po, a historical region in Tibet
nyan  v4 {nyon}	(TR) to listen, to hear
nyan gyi rna gsang ma 	(PN) Ñan-gyi-rna-gsaṅ-ma
nyam chung 	(to be) weak
nyams 	(INTR) to be / get hurt
nyams thag 	(INTR) to be exhausted
nyal 	(INTR) to lie down
nyi dkyil 	solar disc
nyi ma 	sun
nyi shu rtsa bdun 	twenty-seven
nyid 	1) the very; 2) self; 3) alone
nyid du 	as such
nyin 	day
nyin par 	during the day
nyil le 	dangling
nyung 	(to be) few
nye 	(INTR) to be near
nye 'khor 	kindreds
nye ring 	near and distant
nyen 	(INTR) to be pained
nyes 	(INTR) 1) to be hurt; 2) to be bad; 3) to make a mistake
nyes pa 	1) moral fault; 2) evil, offence; calamity
nyo  v2/v4 {nyos}	(TR) to buy
nyon 	see nyan 
nyon mongs pa 	misery, trouble
gnyan 	argali
gnya' ({ba})	neck
gnya' khri btsan po 	(PN) Gñaɣ-khri-bcan-po
gnya' shing 	yoke
gnyid 	dream
gnyis 	two
gnyis ka 	a pair, couple
gnyis pa 	second
gnyis su na 	secondly
gnyen 	(N) relative
gnyen nye 'brel 	(N) relative
gnyen po gsang ba 	(PN) Secret Gñen-po, name of a tutelary deity
gnyen tshan 	relatives
gnyen bshes 	relatives and friends
gnyer 	(TR) to take care
gnyer kha  	attention, care
mnyan du yod pa 	(PN) Mñan-du-yod-pa (also Mñan-yod), Indian town Śrāvasti
mnyan yod 	see mnyan du yod pa 
rnying ma pa 	(PN) Rñiṅ-ma-pa, a school of Tibetan Buddhism
rnyed  v2/v3 {brnyed} / {brnyes}	(TR) 1) to find; 2) to obtain; {dbu rnyed} to introduce
rnyog pa 	whirlpool
snyad  v2/v3 {bsnyad} v4 {snyod}	(TR) to tell, to relate
snyan 	(HON for {rna ba}) ear
snyan pa 	pleasant, well-sounding
snyam 	1) to think; 2) thought
snying rje 	compassion
snying rje ba 	compassionate
snying stobs 	courage
snying po 	quintessence, the main substance
snying brtse ba 	loving, kind
snyung 	illness
snyun 	disease, illness
snyed 	(DET) about; see also de snyed 
snyod  v2/v3 {bsnyod}	(TR) to feed
snyol  v2 {bsnyal}	(TR) to lay down
brnya  v2 {brnyas}	(TR) to borrow
brnyas 	see brnya 
brnyes 	see rnyed 
bsnyad 	see snyad 
bsnyal 	see snyol 
bsnyod 	see snyod 

ting nge 'dzin 	contemplation (Skt. samādhi)
gtang 	see gtong 
gtad 	see gtod 
gtam 	1) rumour; 2) speech
gtam dpe 	proverb
gtam tshig 	words
gti mug 	ignorance
gting 	1) bottom; 2) depth
gtum pa 	(to be) hot-tempered; furious
gter 	1) treasury; 2) tresure
gter kha 	mine
gtog  v2 {gtogs}	{se gol gtog} to snap one’s fingers
gtong  v2 {btang} v3 {gtang} v4 {thong}	(TR) 1) to let go, to send; 2) to give away, to give; 3) to abandon, to leave; 4) to let; 5) to set free; {mthu gtong} to cast spells; {bag mar gtong} to give in marriage; {g.yar gtong} to loan; {sems gso gtong} to console
gtod  v2/v3 {gtad} v4 {thod}	(TR) 1) to direct, to turn, to point (towards + DAT); 2) to deliver up
gtor 	(TR) to scatter
gtor ma 	strewing-oblation
btags 	see 'dogs 
btang 	see gtong 
btab 	see 'debs 
bting 	see 'ding 
btul 	see 'dul 
bteg 	see {'deg}({sa}) 
bton 	see 'don 
rta 	horse
rta bdag 	horse-owner
rta pa 	horseman
rta rdzi 	horse-keeper
rtag tu 	always
rtag pa 	1) lasting, durable; 2) permanence
rting du 	(Adv) later
rting la 	1) (Postp) after (+ GEN); 2) (Adv) later
rting sor 	(Adv) later
rte'u  	foal
rtog  v2 {brtags} v3 {brtag} v4 {rtog}({sa}){}	(TR) to consider, to examine
rtogs 	(TR) to perceive, to apprehend
lta  v2 {bltas} v3 {blta} v4 {ltos}	(TR) to look (at / towards + DAT), to inspect, to examine
lta ci smos 	how much less, not to mention, to say nothing of (+ ABS)
lta bu 	thus
lta bur 	like
ltar 	(Postp) like, as (+ ABS)
ltung  v2 {lhung}	(INTR) to fall
lte ba 	navel
lto 	food
ltogs gri 	hunger
ltogs pa 	hungry
stag 	tiger
stag gi ri 	(PN) Stag-gi-ri
stag phrug 	tiger cub
stag mo 	tigress
stag gzig 'ol mo 	(PN) Stag-gzigs-ɣol-mo, a legendary country
stag ri gnyan gzigs 	(PN) Stag-ri-gñan-gzigs
stan 	mat; seat
steng 	top, surface
steng 	(PN) Steṅ, name of a Tibetan dynasty
steng khang 	upper story
steng du 	1) (Postp) above, on(to) (+ GEN); 2) (Adv) up
steng nas 	(Postp) from (+ GEN)
ste'u 	axe
ster  v2/v3 {bster}	(TR) 1) to allow (to + TERM); 2) to give
stong 	thousand
stong pa nyid 	voidness
stong rtsan 	(PN) Stoṅ-rcan
stod 	higher sphere
stod  v2/v3 {bstod} v4 {stod}	(TR) to praise
ston  v2/v3 {bstan} v4 {ston}	(TR) 1) to teach, to explain; 2) to show, to display; {lung ston} to predict
ston gral 	feast-row
ston thog 	harvest
ston pa 	teacher
ston mo 	feast
stobs 	strength
stobs kyis 	(Postp) due to, because of (+ GEN)
stobs ldan 	strong, powerful
stor 	(INTR) to get lost
brtag pa 	investigation
brtags 	see rtog 
brtan pa 	steadfast
blta 	see lta 
bltas 	see lta 
bstan 	see ston 
bstan bcos 	treatise
bstan pa 	(Buddhist) teaching
bstod 	see stod 

tha ga pa 	weaver
tha chungs 	1) the youngest; 2) youngest
tha ma 	eventually
thag chad pa 	severed
thag chod 	(INTR) to stop
thags 	texture
thang 	plain
thad du 	(Postp) to, towards (+ GEN)
thabs 	means; stratagem
thams 	see 'tham 
thams cad 	1) (N) all; 2) (A) all
thar 	(INTR) to become free (from + DEL)
tha({ra}){ re tho}({ra}){ re}	scatteredly
thar lam 	path of release
thal sgro 	sack of dust
thal lcag 	a hand-slap
thal mo 	palm of the hand
thal tshub 	dust-whirl
thi sho legs 	(PN) Thi-śo-legs
thim 	(INTR) to disappear by being absorbed; to disappear
thu 	(to be) malicious
thu ba 	coat-flap
thug 	(INTR) to be about to (+ DAT)
thugs 	(HON for {snying} / {yid}) mind
thugs skyo shas 	(HON for {skyo shas}) grief
thugs rje 	(HON for {snying rje}) compassion
thugs rje can 	compassionate
thugs nyams 	(HON for {nyams}) mind, heart
thugs dam 	(HON for {yi dam}) 1) tutelary deity; 2) meditation
thugs gdon 	(HON for {gdon}) demon
thugs brtse 	(HON for {brtse}; INTR) to love
thung 	(to be) short
thub 	(TR) 1) to match; 2) to have the command of; 3) to attain; (MOD) to be able, capable; can
the tshom 	doubt
theg pa chen po 	Skt. mahāyana
thog 	what is uppermost
thog tu 	(Postp) on (+ ABS)
thogs 	see 'thogs 
thogs 	(INTR) to get stuck (in + DAT)
thong 	see gtong 
thod 	turban
thon 	see 'thon 
thob 	(TR) 1) to achieve, to attain; 2) to obtain
thos 	(TR) to hear
mtha' 	end
mthu 	1) strength; 2) spell
mthun 	(INTR) to agree; {rjes}({su}){mthun} to agree
mthur 	halter
mtho 	(to be) high
mtho ris 	heaven
mthong 	(TR) to see
'thag  v2 {btags} v3 {btag} v4 {thog}	(TR) to weave; {thags 'thag} (INTR) to weave
'thab 	(TR) to fight
'thab ya 	adversary
'tham  v2 {thams}	(INTR) to shut closely
'thung  v2 {btungs} v3 {btung} v4 {'thung}	(TR) to drink
'thogs  v2 {thogs}	(TR) to carry
'thon  v2/v4 {thon}	(INTR) to go out
'thor 	(INTR) to be scattered

da 	now
da lta 	now
da ltar 	now
da ste 	henceforth, from now on
da lan 	the present
dag par 	really
dang po 	first; at first, at the beginning
dang ba 	(to be) pure
dad 	(INTR) to believe
dad pa 	faithfulness
dam pa 	1) noble; 2) trustworthy
dar 	(INTR) to spread
dar cig 	a moment
dar thang 	(PN) Dar-thaṅ, name of a plain
dar nag 	black silk
dal gyis 	gently
dal med 	without rest
ding khri btsan po 	(PN) Diṅ-khri-bcan-po
dir re ba 	buzzing
du ma 	many
dug 	poison
dug can 	poisonous
dud 'gro 	animal
dud pa 	smoke
dum bu 	piece
dur 	grave
dur khung 	grave
dus 	time
dus su 	(Postp) at the time of, when (+ GEN)
de 	1) (DEM) that; 2) (DET) the; 3) (3SG) he / she / it
de skad 	those words
de nyid 	the very same
de nyid du 	that very moment
de snyed 	such
de lta 	so
de lta bu 	of that kind, such
de ltar 	so, that way; thus
de ltar na 	in that way
de ste 	now
de dus 	at that time
de nas 	thereafter
de bas 	therefore
de bzhin gshegs pa 	Tathāgata
de yang 	see de'ang 
de ring 	today
de sho legs 	(PN) De-śo-legs
de srid 	(COR) so long
de'ang  / {de yang}	namely
der 	1) there; 2) then
des na 	for that reason
do smad 	consort (?) and \her\ children
dogs 	(INTR) to fear (+ ERG)
dong 	see 'dong 
don 	1) meaning, sense; 2) goal, purpose; 3) affair, concern; 4) welfare
don 'khor mda' 	(PN) Don-ɣkhor-mdaɣ
don bsdu 	briefly
dwags 	bright
dwags po 	(PN) Dwags-po, a historical region in Tibet
dwangs pa 	pure
drag 	expedient
drag tu 	vehemently
drag pa 	noble
drag po 	serious
drag zhan 	high and low
drang por 	honestly
drang srong 	sage
drangs 	see 'dren 
dran 	(TR) to remember, to come to mind; to recall
dri 	fragrance
dri ma 	impurities
dri zhim 	nice scent
dril 	see 'dril 
dris 	see 'dri 
drug 	six
drug cu 	sixty
drug po 	a group of six
drung du 	(Postp) near to; to (+ GEN)
drung na 	(Postp) under, close to (+ GEN / ABS)
drung nas 	(Postp) from below (+ ABS)
drung po 	relatives
dres ma 	(PN) a grass species
drongs 	see 'dren 
dron mo 	warm
gdags khri btsan po 	(PN) Gdags-khri-bcan-po
gdang 	(INTR) to open wide
gdan 	bolster, carpet
gda' 	(HML for {'dug}; COP) to be there, to be
gdung brgyud 	(HON) lineage
gdung rabs 	(HON) generation; lineage
gdung({sa}){}	(INTR) 1) to feel pain, to be tormented; 2) to long (for + DAT)
gdeng  v2 {gdengs}	(TR) to raise in despair
gdon mi za bar 	undoubtedly, surely
bdag 	(1SG; HML for {nga}) I
bdag ({po})	master
bdag cag 	(1PL) we
bdud 	demon
bdud mo stag 'dren 	(PN) Bdud-mo-stag-ɣdren
bdud rigs 	demon-race
bdun 	seven
bde 	(to be) happy, peaceful
bde skyid 	1) (INTR) to be happy; 2) happiness
bde ba 	happiness
bde bar 	easily
bden 	(to be) true
bden pa 	1) true; 2) truth
mdangs 	brightness
mda' 	arrow
mda' 	downland, the lower part of a valley
mdun 	front
mdun du 	(POSTP) in front of, before (+ GEN)
mdun so 	incisor (lit. front) tooth
mdor 	in brief
'dam 	swamp
'dam ka  	choice
'da'  v2 {'das}	(INTR) 1) to pass over; 2) to pass away
'dar 	(INTR) to tremble
'das 	see 'da' 
'di 	(DEM) this
'di skad ({ces})	these words
'di lta ste 	in this way; namely
'di lta bu 	like this, such as this
'di ltar 	so, in this manner; this way
'di 'dra 	like this
'ding  v2 {bting} v3 {gding} v4 {things}	(TR) to spread
'du  v2 {'dus}	(INTR) to gather
'du shes can 	thinking, lit. having the faculty of thinking
'dug 	(INTR) 1) to lie (down), to sit (down), to be there; 2) to live; 3) to be
'dul  v2 {btul} v3 {gdul} v4 {thul}	(TR) to subdue
'deg({sa}){} v2 {bteg} v3 {gdeg} v4 {theg}	(TR) to raise, to lift
'ded  v2 {ded}	(TR) to drive away
'debs  v2 {btab} v3 {gdab} v4 {thob}	1) to cast, throw; 2) to establish; {cho nges 'debs} to lament; {sa bon 'debs} to sow seeds; {so sgra 'debs} to whistle; {gsol ba 'debs} to submit a request
'dogs  v2 {btags} v3 {gdags} v4 {thogs}	(TR) to bind, to attach; {phan 'dogs} to render service
'dong  v2/v4 {dong}	(INTR) to go
'dod 	(TR) to wish; to desire; (MOD) to wish, want
'dod chags 	passion, lust
'dod pa 	passion
'dod yon 	desired goods
'don  v2 {bton} v3 {gdon} v4 {thon}	(TR) 1) to utter; 2) to obtain, to extract; 3) to put, to place out; {mgo 'don} to sustain; to take care; {mchi ma 'don} to shed tears
'dra 	(INTR) to be similar, to be like, to resemble (+ COM)
'dri  v2 {dris}	(TR) to ask
'dril  v2 {dril}	(TR) 1) to wrap up; 2) to summarise; {gcig tu 'dril} to unite
'dre  v2 {'dres}	(INTR) to be mixed with
'dren  v2 {drangs} v3 {drang} v4 {drongs}	(TR) 1) to pull; 2) to lead; {gdan 'dren} to invite
'dres 	see 'dre 
'dres pa 	mixture
'drongs 	(INTR) to be invited
rdal  v2/v3 {brdal} v4 {rdol}	(TR) to spread
rdig 	valuables (?)
rdugs 	(INTR) to be worn out
rdung  v2 {brdungs} v3 {brdung} v4 {rdungs}	(TR) to beat
rdul 	dust
rdebs  v2 {brdabs} v3 {brdab} 	(TR) 1) to throw down; 2) to stomp
rde'u  	pebble
rdo 	1) stone; 2) ore
rdo ba 	stone
ldag  v2 {bldags} v3 {bldag} v4 {ldog}	(TR) to lick
ldan 	(to be) possessed of, endowed with (+ COM)
lde 	(PN) Lde, name of a Tibetan dynasty
lde rgyal po 	(PN) Lde-rgyal-po
lde snol nam 	(PN) Lde-snol-nam
lde snol po 	(PN) Lde-snol-po
lde sprin btsan 	(PN) Lde-sprin-bcan
lde 'phrul nam gzhung btsan 	(PN) Lde-ɣphrul-nam-gźuṅ-bcan
lde tshab 	spare key
ldog  v2/v4 {log}	(INTR) to come back
sdar ma 	coward
sdig pa 	1) offence; 2) sin
sdug 	(to be) pretty, nice
sdug 	1) misery; 2) to be pained
sdug bsngal 	1) (to be) afflicted, pained; 2) misery, suffering, affliction
sdug pa 	dear
sdug po 	misery
sdug mad 	a truly miserable person
sdug sran 	hardiness
sdud  v2 {bsdus} v3 {bsdu} v4 {sdus}	(TR) 1) to add; 2) to collect; 3) to gather
sde 	class
sdeb  v2 {bsdebs} v3 {bsdeb} v4 {sdebs}	(TR) to join
sdod  v2 {bsdad} v4 {sdod}	(INTR) 1) to wait; 2) to stay, 3) to live
sdom  v2 {bsdams} v3 {bsdam} v4 {sdoms}	(TR) to bind, to fetter
sdom pa 	vow
brda 	sign
brdabs 	see rdebs 
brdal 	see rdal 
bldag 	see ldag 
bsdad 	see sdod 
bsdams 	see sdom 
bsdus 	see sdud 
bsdebs 	see sdeb 

na 	(INTR) to be ill
na chung 	girl
na bun 	mist
nag pa 	(to be) black
nag mo 	black
nags ma 	forest
nang 	the inside, interior
nang du 	(Postp) into, in (+ GEN)
nang na 	(Postp) among (+ GEN / ABS)
nang nas 	(Postp) from (+ GEN)
nang pa 	(PN) Naṅ-pa
nang({sa}){ par}	day after tomorrow
nad 	illness
nan tar 	very much
nam 	(INT / REL) when
nam mkha' 	sky
nam mkha' lding 	garuḍa-bird, lit. one soaring in the sky
nar nar 	continuously
nar ma 	continuous
nal 	incest
nal lu 	bastard child
nas 	barley
nu bo 	younger brother
nub 	night
nub mo 	evening
nus 	(MOD) to be able, capable; can
non 	(TR) to overcome, to suppress
nor 	1) wealth, goods; 2) cattle
nor can 	1) (A) wealthy; 2) (N) wealthy one
nor bdag 	wealthy man
nor bdag po 	wealth’s owner
nor ldan 	wealthy
nor bu 	jewel
nor med 	impoverished
nor yod 	wealthy
nor slongs 	source of wealth, possessions, lit. “wealth-raising”
gnag 	yak
gnang 	(HON for {ster}; TR) 1) to allow, to permit; 2) to give
gnangs nyin 	the day after tomorrow, the third day
gnam 	the sky
gnam ri srong btsan 	(PN) Gnam-ri-sroṅ-bcan
gnas 	1) (INTR) 1) to last; 2) to live; 3) to stay; 2) (N) place
gnod pa 	pain
mna' ma 	wife
mnar 	(INTR) to suffer, to be pained
mnal 	(HON; INTR) to sleep
rnang  v2 {brnangs}	{skad kyis rnang} to be unable to utter a word; lit. for words to choke
rnam 'gyur 	facial expression
rnam rtog 	disgust
rnam pa 	1) kind; 2) division
rnon po 	sharp
sna 	a kind
sna 	nose
sna tshogs 	all kinds (also {rnam pa sna tshogs})
snang 	(INTR) to appear
snad  v2/v3 {bsnad} v4 {snod}	(TR) to hurt
snam bu 	woollens
snun  v2/v3 {bsnun}	(TR) to stick in
snom  v2 {bsnams} v3 {bsnam} v4 {snoms}	(TR) to take
bsnams 	see snom 
bsnun 	see snun 

pa gu 	brick
pad mo 	lotus
po ta la 	(PN) Po-ta-la, name of a mountain
pre pe stan chung 	(PN) Pre-pe-stan-čhuṅ
dpag med 	countless, innumerable
dpa' 	(to be) courageous
dpal 	glory
dpe 	1) proverb; 2) example
dpog  v2 {dpags} v3 {dpag} v4 {dpogs}	(TR) to measure
dpogs 	see dpog 
dpyad 	see dpyod 
dpyod  v2/v3 {dpyad}	(TR) to examine
dpral ba 	forehead
spang 	meadow
spu 	hair
spu de gung rgyal 	(PN) Spu-de-guṅ-rgyal
spur 	(HON) body, corpse
spo bo 	(PN) Spo-bo, a historical region in Tibet
spong  v2 {spangs} v3 {spang} v4 {spongs}	(TR) to abandon
spongs 	see spong 
spyad 	see spyod 
spyan 	(HON for {mig}) eye
spyan ras gzigs 	(PN) Spyan-ras-gzigs
spyi bo 	crown of the head
spyin 	glue
spyug  v2/v4 {spyugs}	(TR) to banish
spyo  v2 {spyos}	(INTR) to scold
spyod  v2/v3 {spyad}	(TR) 1) to do, to practice, to act; 2) to use; 3) to enjoy
spyod pa 	behaviour, conduct
spyod tshul 	conduct
spyod lam 	mode of life
sprang 	1) (INTR) to beg; 2) (N) beggar
sprang po 	beggar
sprad 	see sprod 
sprin 	cloud
sprug  v2/v4 {sprugs}	(TR) to shake off
sprul pa 	1) transformation; 2) emanation; incarnation
spre 	monkey
spre'u 	monkey
spre'u phrug 	young of a monkey, monkey-child
sprel phrug 	see spre'u phrug 
spro ba 	joy
sprod  v2/v3 {sprad} v4 {sprod}	(TR) 1) to give, to return; 2) to make to meet, to bring together

pha 	father
pha ma 	1) parents; 2) father and mother
pha ming 	father and brother(s)
pha rol 	1) the other; 2) the outside
pha rol na 	(Postp) beyond (+ GEN)
pha shul 	patrimony
phag 	concealment
phag 	swine
phag tu 	secretly
phangs med 	abundant
phan 	1) benefit; 2) (to be) useful
phan bde 	1) happiness; 2) happiness and blessing
phan pa 	1) benefit; 2) (to be) beneficial
phu 	upland, upper part of a valley
phu dung 	sleeve
phu bo 	elder brother
phug 	see 'bugs 
phug ron 	dove
phung po 	heap
phun sum tshogs pa 	accomplishment (Skt. sampatti)
phul 	turret
phul 	see 'bul 
phul gang 	a handful
phul phyin 	victorious
pher 	(TR) to be able, to be able to bear
pho 	(A) male
pho nor 	man’s goods
pho bo 	elder brother
pho brang 	palace, castle
pho lha 	one of tutelary deities
phog 	see 'bogs 
phog 	see 'phog 
phya 	lot
phyag 	(HON for {lag pa}) hand
phyi ma 	later; next
phyi bzhin 	(Postp) after (+ GEN)
phyi rol 	outside
phying ba stag rtse 	(PN) Phyiṅ-ba-stag-rce, name of a castle
phying yul 	(PN) Phyiṅ-yul, name of a region in Central Tibet
phying lung 	(PN) Phyiṅ-luṅ
phyin 	(INTR) to arrive, to go
phyin chad 	(Postp) after (+ ABS)
phyin te lo shu sha 	(PN) Phyin-te-lo-śu-śa, a Tibetan transcription of the Chinese name 賓頭盧埵闍 Bin-tou-lu-duo-she, itself a transcription of Sanskrit Piṇḍoladhvaja (?; cf. Hahn 1996: 318)
phyir 	1) (Adv) 1) back; 2) again; 3) out, outside; 2) (Postp) 1) on account of, due to, because; for the sake of (+ GEN); 2) in order to (+ ABS)
phyir yang 	1) again; 2) afterwards
phyis 	later
phyug 	(to be) rich
phyugs 	cattle
phyung 	see 'byin 
phye 	flour
phye 	see 'byed 
phyed 	see 'byed 
phyed ka  	half
phyed ma 	half
phyogs 	1) direction; 2) side
phyogs la 	(Postp) towards (+ GEN)
phyogs su 	(Postp) towards (+ GEN)
phrag dog 	envy
phrag ({pa})	shoulder
phrad 	particle
phrad 	see 'phrad 
phrin 	message
phru gu 	child
phrogs 	see 'phrog 
'phags rgyal 	(PN) Ɣphags-rgyal, name of an Indian town (Skt. Ujjayinī)
'phags pa 	the Noble One (lit. Surpassing One)
'phangs 	see 'phen 
'pham pa 	despondent
'phur  v2 {phur}	(INTR) to fly
'phen  v2 {'phangs} v3 {'phang} v4 {'phong}	(TR) to throw
'phel  v2 {phel}	(INTR) to increase, to thrive
'pho  v2/v4 {'phos}	(INTR) to change; {tshe 'pho} to die, to be reborn
'phog  v2 {phog}	(TR) to hit
'phya  v2 {'phyas}	(INTR) to deride, to laugh
'phos 	see 'pho 
'phrad  v2 {phrad}	(TR) to meet with (+ COM)
'phrog  v2/v4 {phrogs} v3 {dbrog}	(TR) to take away, to rob; to deprive of

ba 	cow
ba ra bong 	cow, goat, and ass
ba lang 	ox
ba su mi tra 	(PN) Ba-su-mi-tra (Skt. Vasumitra)
bag ma 	bride
bang 	foot-race
bang mdzod 	magazine, treasury
bang so 	tomb, burial mound
bad sa la 	(PN) Bad-sa-la (Skt. Vatsa)
bab 	see 'bab 
babs 	see 'bab 
bar 	1) the middle; 2) middle sphere
bar 'ga' 	sometimes, once
bar chad 	danger
bar du 	(Postp) during, while (+ GEN)
bar la 	(Postp) in the meantime, until (+ ABS / GEN)
bal 	wool
bal po 	Nepalese
bal las 	spinning of wool
bu 	1) child; 2) son
bu ston rin po che 	(PN) Bu-ston Rin-po-čhe (1290–1364), a Tibetan Buddhist master
bu pho 	son
bu mo 	1) daughter; 2) girl
bu smad 	children and \their\ mother
bu tsha 	progeny, offspring, children
bug pa 	hole
bung ba 	bee
bud med 	woman
bong bu 	ass
bod 	(PN) Tibet
bod skad 	Tibetan language
bod pa 	Tibetan (man)
bod mo 	Tibetan (woman)
bod yig 	written Tibetan
bon 	(PN) Bon, an indigenous Tibetan religion
bon po 	a male adherent of the Bon religion
bor 	see 'bor 
bos 	see 'bod 
bya 	1) bird; 2) hen
bya 	see byed 
bya khri 	(PN) Bya-khri
bya ba 	1) deed, act, affairs; 2) (so-)called
bya mo 	hen
bya tshogs 	(PN) Bya-chogs, name of a forest
bya rog 	crow
byang 	north
byang chub 	enlightenment
byang chub sems dpa' 	Skt. bodhisattva
byams mgon 	protector of benevolence
byams pa 	1) kindness, love; 2) (TR) to love (+ DAT); 3) (PN) Byams-pa (Skt. Maitreya)
byas 	see byed 
byi 	rat
byi 	see 'byi 
byin 	blessing
byin 	see sbyin 
byi'u  / {bye'u} 	nestling
byis pa 	child
byung 	see 'byung 
bye 	see 'bye 
byed  v2 {byas} v3 {bya} v4 {byos}	(TR) 1) to do, to make, to commit; to prepare; 2) to speak; 3) to act as (+ ABS); 4) to determine; {khyim thab byed} to establish a family; {mchod pa byed} to make offerings; {gtam byed} to make a speech; {dbang byed} to rule (over + DAT); {mos gus byed} to pay respect; {gtso byed} to lead, to be most prominent; {bcol gtams byed} to entrust; {tshags byed} to save; {tshe'i dus byed} to die; {zhes bya ba} called; {so nam byed} to cultivate fields
bye'u 	see byi'u 
byon 	see 'byon 
byos 	see byed 
bra bo 	buckwheat
brag 	rock
brag srin mo 	rock-ogress
bran 	servant
bran bzangs 	(PN) Bran-bzaṅs
bram ze 	Brahmin
bral 	see 'bral 
brin pa 	in demand; precious
bris 	see 'bri 
brel 	(INTR) to be separated from, to be without
bres 	manger
bro ba 	taste
bros 	see 'bros 
bla 	sign, symbol
bla 	1) (to be) superior, better; 2) what is above
bla ma 	lama, teacher
blang dor 	attracting and repelling
blangs 	see len 
blun po 	(N) fool
blo 	mind, thought
blo gros 	1) intelligence, intellect; 2) understanding
blo ngan 	evil-minded
blo chung 	narrow-minded
blo 'dod 	greed
blo ldan 	intelligent, wise
blon che 	great councillor
blon po 	minister
dbang 	1) power; 2) (TR) to control, to own
dbang gis 	(Postp) perforce (+ GEN)
dbang po 	sense
dbang med 	powerless
dbu 	(HON for {mgo}) head
dbu skra 	(HON for {skra}) hair
dbugs 	breath
dbul phongs 	(to be) poor
dbus su 	(Postp) in the middle of (+ GEN)
dbyar ({ka})	summer
dbyig pa can 	(PN) Dbyig-pa-čan (Skt. Daṇḍin)
dbyings 	height
dbyug 	stick
dbyu({ga}){ gu}	stick
'bangs 	subject, servant
'bab  v2 {bab} / {babs}	(INTR) to come down, to descend (C); to fall (NC); {dus la 'bab} for the time to come
'ba' zhig 	1) alone, mere; 2) only
'bugs  v2 {phug} v3 {dbug} v4 {phug}({sa}){}	(TR) to bore
'bud  v2/v4 {phus} v3 {dbu}	(TR) to blow
'bum 	hundred thousand
'bul  v2/v4 {phul} v3 {dbul}	(HML for {sbyin} / {ster}; TR) to offer
'bogs  v2/v4 {phog} v3 {dbog}	(TR) to give
'bod  v2/v4 {bos}	(TR) to call, to summon
'bor  v2/v4 {bor}	(TR) to leave behind; to abandon; {dmod 'bor} to pronounce a prayer
'byi  v2 {byi}	(INTR) to fall off
'byin  v2/v4 {phyung} v3 {dbyung}	(TR) to cause to come forth / out, to take out
'byung  v2 {byung}	(INTR) 1) to occur, to appear; 2) to happen, to become; 3) to be born (to + DAT); 4) to come out; {rab tu 'byung ba} to join (the religion of Buddha; Skt. pra-√vraj “to go forth, to proceed; to become a monk”)
'byung po 	demon
'bye  v2 {bye}	(INTR) 1) to open; 2) to divide
'byed  v2 {phye} / {phyed} / {phyes} v3 {dbye} v4 {phyes}	(TR) to divide, to separate; to open; {shan 'byed} to differ
'byon  v2 {byon}	(HON; INTR) 1) to arrive; 2) to appear; 3) to set off
'byor ldan 	rich
'byor pa 	wealth
'brang snyan lde ru 	(PN) Ɣbraṅ-sñan-lde-ru
'bral  v2 {bral}	(INTR) to be deprived (of + COM); {srog dang 'bral} to die
'bri  v2/v4 {bris} v3 {bri}	(TR) to write
'bring po 	1) (N) the middle one; 2) (A) middle
'bru 	corn
'brug 	dragon
'brel 	(TR) to unite with, to be associated with (+ COM)
'brong zher legs 	(PN) Ɣbroṅ-źer-legs
'brong ru 	horn of a wild yak
'bros  v2 {bros}	(INTR) to flee
sbal pa 	frog
sbas 	see sbed 
sbed  v2 {sbas} v3 {sba} v4 {sbos}	(TR) to hide, to conceal
sbom po 	plump
sbyar 	see sbyor 
sbyin  v2/v4 {byin}	(TR) to give, to bestow, to offer
sbyor  v2/v3 {sbyar} v4 {sbyor}	(TR) to compare (with + COM); to join
sbra 	tent
sbrang rtsi 	honey
sbrul 	snake

ma 	mother
ma 	(NEG) not
ma thag ({tu})	immediately thereafter, right after (+ v2 or +ABS)
ma smad 	mother and \her\ children
ma 'ongs pa 	future
ma rig pa 	ignorance
ma lus par 	completely
mag pa 	son-in-law
mang  v2 {mangs}	(INTR) to be many
mang du 	many; a lot, much
mang po 	many; numerous
mangs 	see mang 
mar 	butter
mar pa 	(PN) Mar-pa
mi 	(NEG) not
mi 	man, human being
mi thod gad kha 	(PN) Mi-thod-gad-kha, a place name
mi brgyud 	lineage
mi snyan 	unpleasant
mi bdag 	false-master, lit. non-master
mi nor 	man’s wealth
mi la shes rab rgyal mtshan 	(PN) Mi-la-śes-rab-rgyal-mchan, the father of Mi-la-ras-pa
mi las 	labour
mig 	eye
ming 	name
ming sring 	brother and sister
min 	(NEG COP of {yin}) not to be
mi'u 	dwarf
mu khri btsan po 	(PN) Mu-khri-bcan-po
me 	fire
me khri btsan po 	(PN) Me-khri-bcan-po
me tog 	flower
me long 	mirror
me shing 	firewood
med 	(NEG COP of {yod}) 1) not to be, not to exist; 2) not to have
mo 	1) (3SG F) she; 2) (A) female
mo nor 	woman’s goods
mo ma 	diviner
mod 	(INTR) to be abundant, to abound
mos 	(INTR) to take pleasure in (+ DAT)
mos gus 	respect
mya ngan 	affliction, misery; trouble
mya ngan med 	(PN) Mya-ṅan-med (Skt. Aśoka)
mya ngan las 'das pa 	Skt. nirvāṇa
myang tsha dkar rgyan 	(PN) Myaṅ-cha-dkar-rgyan, Mi-la-ras-pa’s mother
myur du 	quickly
myur ba 	quick
myur bar 	quickly
myong  v2 {myangs} v3 {myang}	(TR) to experience
dmag 	army
dmag brgya pa 	(PN) Dmag-brgya-pa (Skt. Śātānīka)
dmag pa 	son-in-law
dmar po 	red
dmus long 	blind
dmus long dkon pa bkra 	(PN) Dmus-loṅ-dkon-pa-bkra
dmod 	prayer
dmyal ba 	hell
rmi  v2 {rmis}	(TR) to dream; {snyam rmi} to dream
rmi lam 	dream
rmu thag 	{rmu}-rope
rmo  v2/v4 {rmos}	(TR) to sow and plough
rmong  v2 {rmongs}	(INTR) to get confused
rmongs 	see rmong 
rmongs pa 	(N) ignorant
rmos 	see rmo 
sman 	medicine, herb
sman pa 	physician
smin 	ripe
smon 	(TR) to desire (+ DAT)
smyu gu 	reed-pen
smyug ma 	reed
smra  v2/v3 {smras} v4 {smros}	(TR) to speak; to say
smras 	see smra 
smre sngags 	lamentation
smros 	see smra 

tsam 	(DET) mere, only; as much as, about
tsam du 	1) as if, like; 2) like that
tsong kha 	(PN) Coṅ-kha, historical region east of the Kokonor Lake
tsong kha pa 	(PN) Coṅ-kha-pa, a renown Tibetan Buddhist teacher
gtsang ma 	clean
gtsug 	crown of the head
gtse  v2 {gtses}	(TR) to harm, to torment
gtses 	see gtse 
gtso bo 	the best, eminent one
btsan 	(PN) Bcan, name of a Tibetan dynasty
btsan thang gong ma 	(PN) Bcan-thaṅ-goṅ-ma, name of a plain
btsan po 	emperor in the Tibetan Empire
btsa'  v2 {btsas}	(INTR) to bring forth
btsal 	see 'tshol 
btsas 	see btsa' 
btsun pa 	respectable, noble
btsun mo 	queen
btson 	prisoner
btson ra 	prison
btsos 	see 'tshod 
rtsa 	1) foot (of a mountain etc.); 2) place
rtsa 	(PN) Rca, a place name
rtsar 	(Postp) before, in front of (+ GEN)
rtsal 	physical skills
rtsig  v2 {brtsigs} v3 {brtsig} v4 {rtsigs} 	(TR) to built, to erect
rtsig pa 	wall
rtsis 	divination
rtse  v2/v4 {rtses}	(INTR) to play
rtse ({mo})	summit
rtse'u 	thorn
rtsog pa 	dirty
rtsog rtsog pa 	completely nasty, messed
rtsod  v2 {brtsad}	(TR) to argue, to debate (about + DAT)
rtsod pa 	conflict
rtsom  v2 {brtsams} v3 {brtsam} v4 {rtsoms}	(TR) to plan, to commence
rtswa kha 	grass
stsal 	see stsol 
stsol  v2/v3 {stsal}	(HON) to give, to bestow; {bka' stsol} (HON) to speak, to order
brtsad 	see rtsod 
brtsams 	see rtsom 
brtsigs 	see rtsig 
brtse 	(INTR) to love
brtson 'grus 	effort; diligence

tsha 	hot
tsha 	see tshwa 
tsha le 	alum
tshags 	see s.v. byed 
tshang 	den
tshad 	(N) all
tshad med pa 	immeasurable
tshabs 	very great
tshal 	forest
tshal ba 	splinter
tshig 	word
tshim pa 	satisfied
tshugs 	(TR) to harm
tshugs 	see 'tshugs 
tshud 	see 'tshud 
tshur 	here, hither
tshul 	way, manner
tshul du 	(Postp) like ( + GEN)
tshe 	1) time; 2) life
tshe dang ldan pa 	elder, venerable (a title)
tshe 'dzugs 	she-goat
tshe srog 	life
tshes 	day
tshogs 	crowd, troop
tshogs 	see 'tshogs 
tshong 	trade
tshod 	the right amount / measure
tshon 	paint
tshor 	(TR) to recognise, to perceive
tshol 	see 'tshol 
tshol ba 	search
tshwa 	salt
mtshan 	1) (HON for {ming}) name; 2) characteristic mark, sign
mtshams su 	(Postp) between (+ ABS)
mtshar ba 	beautiful
mtsho 	lake
'tshang  v2 {sangs}	(INTR) to recover, to wake up
'tshal 	(TR) to wish; {phyag 'tshal} to pay homage
'tshugs  v2 {tshugs}	(INTR) to be settled / established
'tshud  v2 {tshud}	(INTR) to enter
'tshe  v2 {btses} v3 {btse}	(TR) to hurt
'tsho  v2/v4 {sos}	(INTR) to remain alive; to recover (from illness)
'tsho  v2 {bsos} v3 {bso} / {gso}	(TR) 1) to take care; 2) to tend; {srid 'tsho} to rule a dominion
'tshogs  v2/v4 {tshogs}	(INTR) to gather
'tshod  v2 {btsos} v3 {btso} v4 {tshos}	(TR) to cook, to roast, to brew
'tshol  v2/v3 {btsal} v4 {tshol}	(TR) 1) to get, to obtain; 2) to search

mdzangs 	wise
mdzad  v4 {mdzod}	(HON for {byed}; TR) to do; to act (as + ABS); {skyabs mdzad} to protect, to save; {gtso mdzad} to lead, to be most prominent; {brtson 'grus mdzad} to strain oneself
mdzad pa 	(HON) deed
mdza' bo 	lover
mdzub mo 	fore-finger
mdze 	leprosy
mdzes pa 	(PN) Mȷes-pa
mdzes se 	(PN) Mȷes-se
mdzo 	mȷo, a hybrid between yak and domestic cattle
mdzod 	cache, repository
mdzod 	see mdzad 
'dzad  v2 {zad}	(INTR) 1) to be consumed; to disappear; 2) to run out; {ma zad} not only
'dzam bu gling 	continent (Skt. Jambūdvīpa, name of the Indian continent in Buddhist cosmology)
'dzin  v2 {bzung} v3 {gzung} v4 {zungs}	(TR) 1) to seize, to grasp, to hold; to take over; 2) to take sth. (DAT) as (TERM); {yid la 'dzin} to take to \one’s\ mind
'dzugs  v2 {btsugs} v3 {gzugs} v4 {zugs}	(TR) to place
'dzem med 	one having no shame
rdza 	silt
rdzas 	object
rdzi'u 	herdsman
rdzu 'phrul 	magic tricks, miracles

wa ro 	fox cadaver

zhag 	day
zhang mda' 	(PN) Źaṅ-mdaɣ
zhang po 	maternal uncle
zhang zhung 	(PN) Źaṅ-źuṅ, name of an ancient polity
zhan pa 	ordinary
zhabs 	(HON for {rkang pa}) foot
zhal 	(HON for {kha}) mouth
zhal che 	judgement
zhal che pa 	judge
zhal chems 	(HON for {kha chems}) testament
zhal 'dzum 	(HON) smile
zhi 	(INTR) to be calm
zhing 	field
zhing skal 	field-share
zhing pa 	peasant
zhing las 	field-work
zhib pa 	exact
zhib par 	minutely
zhu  v2 {zhus}	(HML for {zer} / {smra}) 1) to speak; 2) to ask
zhugs 	see 'jug 
zhugs 	(HON for {me}) fire
zhus 	see zhu 
zhe sdang 	hatred
zhen 	(INTR) 1) to fix, to penetrate; 2) to long for (+ DAT)
zhes pa ltar 	as the so-called
gzhan 	1) (A) other; foreign; 2) (N) the other
gzhan du 	differently
gzhan yang 	furthermore
gzhi 	cause
gzhi ma 	foundation
gzhung 	middle
gzhun po 	excellent
gzhon 	young
gzhon nu 	1) (N) a youth ; 2) (A) young
bzhag 	see 'jog 
bzhams 	(TR) to calm down, appease
bzhi 	four
bzhi bcu 	fourty
bzhin 	face
bzhin 	(Postp) according to, in accordance with; like (+ ABS)
bzhin du 	(Postp) according to; like (+ ABS)
bzhugs 	(HON for {'dug}; INTR) 1) to stay, abide; to sit; 2) to be alive
bzhus 	see 'ju 
bzhengs 	(HON; INTR) to rise, get up
bzhes 	(HON for {len}; TR) to take; {thugs nyams su bzhes} to experience, to practise
bzhon pa 	riding-beast

za  v2 {bzas} / {zos} v3 {bza'} v4 {zo}({sa}){}	(TR) to eat; {zan za} (INTR) to eat
za nam zin te 	(PN) Za-nam-zin-te
zangs 	copper
zangs rdo 	copper-ore
zad 	see 'dzad 
zad par 	completely
zan 	food
zab pa 	(to be) deep
zab mo 	profound
za({ra}){ ri zi}({ra}){ ri}	confused
zas 	food
zas gtsang ma 	(PN) Zas-gcaṅ-ma (Skt. Śuddhodana)
zin 	(INTR) 1) to be seized with, to be taken over by (+ ERG); 2) to finish
zil pa 	dew
zug rngu 	grief
zungs 	see 'dzin 
zur 	outline
zur nas 	(Adv) for one’s part
zer 	(TR) 1) to say; 2) to call
zer ba 	saying
zo 	see za 
zo dang gong po ri 	(PN) Zo-daṅ-goṅ-po-ri
zos 	see za 
zla ba 	month
zla ba 	(PN) Zla-ba
gzigs 	(HON for {mthong} / {lta}; TR) 1) to see; to look (at / in + DAT); 2) to regard
gzir 	(INTR) 1) to be pained, to suffer; 2) to be harassed, troubled
gzug 	quarter share
gzugs 	1) body; 2) shape
gzugs can snying po 	(PN) Gzugs-čan-sñiṅ-po (Skt. Bimbisāra)
gze ru  	small nail
gzer 	nail
gzer bu 	small nail
bzang 	(to be) good
bzang po 	excellent, good
bza' ba 	food
bza' mi 	husband and wife
bzung 	see 'dzin 

'a ci 	(PN) Ɣa-či, name of an ancient polity in Central Asia
'u cag 	(1PL) we
'u bu cag 	(1PL) we
'um bu glang mkhar 	(PN) Ɣum-bu-glaṅ-mkhar
'o skol 	(1PL) we
'o brgyal 	difficulty, trouble
'o cag 	(1PL) we
'o na 	(Intrj) well; now then
'o ma 	milk
'o lags so 	very well, all right
'og 	1) nether sphere; 2) ground floor
'og tu 	(Postp) after (+ GEN)
'og na 	1) (Adv) below, underneath; 2) (Postp) below (+ GEN)
'ong  v2 {'ongs}	(INTR) 1) to come; 2) to become, to be; {legs par 'ongs so} lit. “\You\ have arrived well” (an official greetings formula of an admission to the Buddhist order)
'ongs 	see 'ong 
'od 	light
'od zer 	ray
'on te 	or if not, or else, or also
'or ma 	(PN) Ɣor-ma
'os 	(INTR) to be suitable

yang 	(Adv) 1) again; 2) still, more; 3) further
yang dag 	really
yang na 	or
yang yang 	again and again
yan 	(Postp) up to (+ ABS)
yan la 	(Postp) till (+ ABS)
yan lag 	limb
yab 	(HON for {pha}) father
yab mes 	ancestors
yab yum 	(HON for {pha ma}) 1) father and mother; 2) parents
yar 	up, upward
yar lungs 	(PN) Yar-luṅs, historical region in Central Tibet
yar lha sham po 	(PN) Yar-lha-śam-po, name of a mountain and its mountain deity
yal 	(INTR) to disappear
yi 	mind; see yid 
yi ge 	(written) text; letter
yi dgas 	hungry ghost
yi mug 	(INTR) to despair, to be tormented
yig tshang 	document
yid 	1) mind; 2) heart
yin 	(COP) to be
yug 	piece of cloth
yung ba 	turmeric
yun 	time
yun ring du 	(Adv) for a long time
yum 	(HON for {ma}) mother
yur 	channel
yul 	region, country, land
yul khams 	country
yul mi 	countryman
yus 	blame
yong  v2 {yongs}	(INTR) to come
yongs su 'grol  v2 {grol}	(INTR) to become absolutely free
yongs su len 	see len 
yod 	(COP) 1) to be, to exist; 2) to have
yon tan 	1) (excellent) quality, virtue; 2) good skill
yon tan can 	excellent
yos 	hare
g.yag 	yak
g.yang 	prosperity, fortune
g.ya' 	slate
g.yar 	1) (TR) to borrow; 2) loan
g.yas 	(A) right
g.yu 	turquoise
g.yung drung 	(PN) G.yuṅ-druṅ, school of Bon religion
g.yog 	servant
g.yog  v2 {g.yogs}	(TR) to cover
g.yog mo 	female servant
g.yogs 	see g.yog 
g.yon 	left

ra 	goat
ra mda' 	help
rang 	1) self; itself; 2) own; 3) merely
rang  v2 {rangs}	(INTR) to rejoice; {rjes su yi rang} to rejoice; {yi rang} to rejoice, to be happy (about + DAT)
rang nyid 	1) just; 2) oneself
rang re 	(1PL INCL) we
rang las 	one’s own worker
rangs 	see rang 
ran 	(INTR) to be right (to do sth. + v3 )
rab 	1) the eldest; 2) the best; 2) eldest;
rab tu 	very
rab tu byed pa 	chapter (Skt. prakaraṇa)
rab byung 	a cycle of sixty years
ral gri 	sword
ral pa 	lock
ral ba 	torn
ras 	cotton cloth
ras chung pa 	(PN) Ras-čhuṅ-pa
ri 	mountain
ri dwags 	animals
ri bo 	mountain
ri bong 	hare
ri mo 	picture
ri rab 	(PN) Ri-rab, a mountain in Indian cosmology (Skt. Sumeru)
ri lu  	globula, pill
rig gnas 	science
rig pa 	knowledge
rig 'dzin 	knowledge holder (Skt. vidyādhara)
rigs 	1) family, lineage; race; state; 2) kind
rigs 	(INTR) 1) to have the way, manner, to be suitable / right / appropriate (+ GEN / TERM); 2) (MOD) must
rigs rgyud 	race
rigs ngan 	hangman
rigs mthun 	of one breed, lit. agreeing in kind
rigs pa 	method
ring  v2 {rings}	(INTR) to be long
ring po 	1) long; 2) far away
ring por 	(Adv) long
ring zhig 	long time
ring zhig tu 	(Adv) for a long time
ring la 	(Postp) when, during (+ ABS)
rid pa 	(to be) meagre, emaciated
rin che 	see rin po che 
rin po che 	(N) jewel, precious stone; (A) precious
rim gyis  	successively, in a row
rim pa 	row
rim par 	in succession
rims 	plague
ril ba 	round
ril bu 	globula, pill
ru la skyes 	(PN) Ru-la-skyes
rung 	(INTR) to be suitable; to be worth
rus pa 	bone
rus bu 	small bone
re 	(DET) each, every; single
re 	(TR) to wish
re re nas 	individually
res 	once
ro 	body, corpse
rog po 	black
rod 	constitution
rwa 	horn
rlon pa 	fresh
rlob  v2 {brlabs} v3 {brlab} v4 {rlobs}	{byin gyis rlob} (TR) to bless, to grant (one’s) blessing
brlabs 	see rlob 

lag ({pa})	hand, arm
lag mgo 	fist
lag bcud che 	excellent housewife (contextual translation)
lag dpon 	constructor
lags 	(HON for {yin}; COP) to be
lags 	(HON address) dear
lang  v2 {langs}	(INTR) to rise, stand up
langs 	see lang 
lan 	time, turn
lan 'ga' 	sometimes
lan cig phyir mi ldog pa 	lit. one who does not come back again (Skt. anāgāmin)
lab 	gossip
lam 	road, way
lar 	but
las 	1) work; 2) (previous) action (Skt. karman)
las ka  	work
las bskos 	fate
lings 	hunting
lug 	sheep
lu({ga}){ gu}	lamb
lug zla 	sheep-month
lugs 	tradition
lung 	prophecy
lung rings 	(PN) Luṅ-riṅs, a place name
lus 	1) body; 2) life
lus 	(INTR) to be remaining, left
lus stobs 	physical strength
lus med par 	completely, lit. so that there are no remains
lus srog 	body and life
legs 	(to be) good
legs 	(PN) Legs, name of a Tibetan dynasty
legs pa 	1) good, correct; 2) good deed
legs par 	well
legs par bshad pa 	aphorism, lit. well-said-one
legs bshad 	see legs par bshad pa 
len  v2 {blangs} v3 {blang} v4 {long}({sa}){}	(TR) 1) to obtain; to accept; 2) to take; 3) to take away; 4) to attract; {yongs su len} to accept
le'u 	chapter
lo 	year
lo rgyus 	account; life story
lo thog 	harvest, crop
lo ma 	leaf
log 	(INTR) to turn; {gnyid log} to fall asleep
long 	see len 
long ngam 	see long ngam rta rdzi 
long ngam rta rdzi 	(PN) Loṅ-ṅam-rta-rȷi
long ba 	blind
longs spyod 	(TR) to use
lon 	(INTR) to elapse, to pass (of time + ABS)

sha 	1) flesh, meat; 2) body
sha ko ta ka 	a tree species (Skt. śākhoṭaka)
sha bkrag 	body-beauty
sha khog 	body of a slaughtered animal
sha khri 	(PN) Śa-khri
shan 	difference
sham thabs 	lower garment
shar 	see 'char 
shi 	see 'chi 
shig sro 	louse and nit
shing 	1) wood; 2) tree
shing mkhan 	carpenter
shing rta 	chariot
shing rta chen po 	(PN) Śiṅ-rta-čhen-po
shing thog 	fruit (of trees)
shing nags 	forest
shing lo 	tree-leaf
shin tu 	very
shugs ring 	sigh
shul 	empty place
shes 	(TR) 1) to know, be aware of; 2) to recognise, to realise; (MOD) to be able, capable; can; {ngo shes} to realise, to recognise
shes pa  	intelligent
shes bya 	subject matter of knowledge
shes rab 	understanding, wisdom
shes rab ldan pa 	sage
shes rig 	knowledge
shog 	see gshegs 
shom  v2 {bshams} v3 {bsham} v4 {shoms}	(TR) to prepare
shos 	the other (of two)
shAkya thub pa 	(PN) Śākyamuni
shAkya ri brag pa 	(PN) Mountain-Śākya
gsha' ma 	righteous
gshe  v2 {gshes}	(INTR) to inveigh (against + DAT)
gshegs  v4 {shog}	(HON for {'ong} / {'gro}; INTR) to come, to go
gshegs rdzongs 	(HON) farewell ceremony
gshen rab mi bo 	(PN) Gśen-rab-mi-bo, a legendary founder of the Bon religion
gshol 	plough
bshad 	see 'chad 
bsham 	see shom 
bshig 	see 'jig 
bshes gnyen 	spiritual friend (Skt. kalyāṇamitra)

sa 	1) earth; 2) place; 3) ground; 4) terrestrial sphere
sa ga 	(PN) name of a lunar mansion (Skt. vaiśākha)
sa rta 	Earth-Horse (year)
sa phung 	mass of soil
sa bon 	seeds
sa ri 	(PN) name of a lunar mansion (Skt. svātī)
sangs 	see 'tshang 
sangs rgyas 	Buddha
sad 	(INTR) to wake up; {gnyid sad} to wake up
su 	(INT) who?
su yang 	anybody
sum cu 	thirty
sum cu dgu pa 	thirty-ninth
se 	nugget
se gol 	snapping one’s fingers
se snol nam lde 	(PN) Se-snol-nam-lde
se 'u 	pomegranate
seng ge 	lion
seng seng 	thin
sems  v2 {bsams} v3 {bsam} v4 {soms}	1) (TR) to think (about / of + DAT as + TERM); {snyam sems} to think; 2) .1) mind; 2) thought; 3) heart
sems can 	living / sentient being
sems can chen po 	(PN) Sems-čan-čhen-po
sems can dmyal ba 	hell
sems chung 	timid
sems gso 	consolation
ser ga 	crack, fissure
ser po 	yellow
sel ba 	(TR) to clean away
so nam 	agriculture
so 	1) tooth; 2) tooth
so khri btsan po 	(PN) So-khri-bcan-po
so sgra 	whistling through the teeth
so nam 	agriculture
so ba 	unhusked barley
so ma 	new
so tshis 	housekeeping
so so 	everyone
so so nas 	individually
so sor 	separately
sog 	see gsog 
sog kha 	scapula
sogs 	and so forth; such as, including, among others (+ DAT / ABS)
song 	see 'gro 
sol ba 	charcoal
sos 	see gso 
sran ma 	beans
sras 	(HON for {bu}) son
sring mo 	sister
srid 	1) (COP) 1) to exist, to be; 2) to be possible, to be able; 2) (N) dominion
srid pa 	existence
srid gsum 	triple world
srin po 	demon
srin mo 	demoness
srib khri btsan po 	(PN) Srib-khri-bcan-po
srung  v2 {bsrungs} v3 {bsrung} v4 {srungs}	(TR) to guard, to protect
sreg  v2 {bsregs} v3 {bsreg} v4 {sregs}	(TR) to burn
srog 	life
srog chags 	living / animated being, animal
sla ba 	easy
slad 	back part; {slad bzhin par} behind
slad du 	(Postp) on account of; in order to (+ GEN)
slar 	(Adv) back
slas 	retinue
slu  v2 {bslus} v3 {bslu} v4 {slus}	(TR) to entice, to deceive, to bewitch
slong  v2 {bslangs} v3 {bslang} v4 {slongs}	(TR) 1) to ask, to order; 2) to beg
slongs 	begging
slob  v2 {bslabs} v3 {bslab} v4 {slobs}	(TR) to learn, to study
slob dpon 	teacher
gsad 	see gsod 
gsan 	(HON for {nyan}; TR) to hear, to listen; {snyan gsan} to listen
gsal 	(to be) clear, visible
gsal rgyal 	(PN) Gsal-rgyal (Skt. Prasenajit)
gsung  v2 {gsungs}	(HON for {zer} / {smra}; TR) to speak, to say, to proclaim
gsung ngag 	(HON for {ngag}) wording
gsungs 	see gsung 
gsum 	three
gsum ka 	a trio, the three
gsum pa 	a few
gsum po 	a trio, a group of three
gser 	gold
gso  v2 {gsos} / {bsos} v3 {bso} v4 {sos} 	(TR) 1) to take care; to train; 2) to rear, to nourish; 3) to cure; to restore; {ngal gso} to rest, to take a rest; {sems gso} to console
gsog  / {sog} v2 {bsags} v3 {bsag} v4 {sogs}	(TR) to gather
gsod  v2 {bsad} v3 {gsad} v4 {sod}	(TR) to kill
gson mchad zlum po 	(PN) Gson-mčhad-zlum-po, name of a grave
gson po 	(A) alive
gson por 	(Adv) alive
gsol 	(HML; TR) 1) to request; 2) to speak
gsol ba 	request
bsags 	see gsog 
bsad 	see gsod 
bsam ({pa})	thought
bsams 	see sems 
bsu  v2/v4 {bsus}	(TR) to join
bso 	see gso 
bsod snyoms 	alms
bsod nams 	virtue, merit
bsrung 	see srung 
bsrungs 	see srung 
bsregs 	see sreg 
bslang 	see slong 
bslangs 	see slong 
bslab 	see slob 
bslabs 	see slob 
bslus 	see slu 

ha cang 	very
har 	suddenly
hrul ba 	tattered
lha 	1) deity; 2) lord
lha chen po 	(PN) Lha-čhen-po
lha tho tho ri snyan shal 	(PN) Lha-tho-tho-ri-sñan-śal
lha ma yin 	semi-god
lha mo 	1) goddess; 2) queen
lha ri rol po 	(PN) Lha-ri-rol-po, a mountain
lha sras 	divine son, son of the gods
lhag 	the rest, remains
lhag par 	more
lhag lus 	the rest, remains
lhag ma 	remnant
lhags 	(INTR) to come together
lhan du 	at the same time
lhab lhub 	wide, flowing
lham 	shoe
lhu 	minor share
lhung 	see ltung 
lhung bzed 	alms-bowl
lhub 	width

a khu 	paternal uncle
a ne 	aunt
a ma 	mother
a zhang 	maternal uncle
a sho legs 	(PN) Qa-śo-legs
i sho legs 	(PN) Qi-śo-legs
