'di 'dra	dindra
'du 'bral	dudral
'du 'dzi	dudzi
a mdo	amdo
b+h+rUM	droom
badzrI	benzi
badzra	benza
bco brgyad	chobgyé
bde 'gro	dendro
bde mchog	demchok
bkra shis	tashi
bla 'og	la'o
bla brang	labrang
bras ljongs	drenjong
byang chub	changchub
byin gyis rlobs	jingyi lob
chab mdo	chamdo
che mchog	chemchok
ci 'dra	chindra
da lta	danta
da ltar	dantar
de 'brel	dendrel
de 'dra	dendra
de bi	devi
de wa	deva
dga' ldan	ganden
dge 'dun	gendün
dka' 'grel	kandrel
ga 'dra	gandra
karma	karma
le'u	le'u
lha rje	lharjé
lo 'dab	lodab
maN+Da la	mandala
maN+Dal	mendal
man ngag	mengak 
mkha' 'gro	khandro
mkhas 'jug	khenjuk
na kra	nakra
ngag dbang	ngawang
o rgyan	orgyen
pa d+ma	pema
pad+ma	pema
phat	pé
phaT	pé
phru gu	pugu
rdo rje	dorje
rdzogs chen	dzogchen
re 'dod	rendö
rgyal rtse	gyantsé
rgyu 'bras	gyundré
rgyu 'grul	gyundrul
rgyu mtshan	gyumtsen
rig pa	rigpa
rta mgrin	tamdrin
sa 'og	sawo
sa bcad	sabché
sangs rgyas	sangye
sarba	sarva
sde dge	derge
sgro 'dogs	drondok
sid+d+hi	siddhi
skyabs 'gro	kyamdro
skye 'gro	kyendro
skye mched	kyemché
sprul sku	tulku
spyod 'jug	chönjuk
svaha	soha
swA hA	soha
tiSh+Tha	tishta
tshe 'dzin	tsendzin 
tsit+ta	tsitta
u rgyan	urgyen
wAka	waka
ze'u	ze'u
zhe 'dod	shendö
e ma hoH	emaho
ye shes	yeshe
ye she	yeshe
pi waM	piwam
ut+pal	utpal
yid 'ong	yi'ong
dpal be'u	palbe'u
d+harma	dharma
swasti	svasti
swa sti	svasti
mi 'gyur	mingyur
rig 'dzin	rigdzin
pad+mo	pemo
rig	rig
'ja' 'od	ja'ö
ma 'ongs	ma'ong
man+da rA ba	mandarava
dbang bsgyur ba	wang gyurwa
he ru kaH	heruka
he ru ka	heruka
dpal chen po	palchenpo
bkra mi shis pa	trami shipa
bi dza ya	vidzaya
pad+ma'i	pemé
bsod rgyal	sogyal
byang sems	changsem
bar+dza	benza
hU~M	hung
hU~M`	hung
oM	om
AH	ah
b+h+yo	jo
b+h+yoH	jo
bi shwa	bisho
mu khe b+h+yaH	mukhebé
ta khaM	takham
ud+ga te	udgaté
s+pha ra Na	saparana
i maM	imam
ga ga na	gagana
b+h+rU~M	droom
wA gi	vagi
shwa ri	shvari
he tu	hetu
d+ha rmA	dharma
pra b+hA wA	prabhava
ni ro da	nirodha
e waM	evam
wA dI	vadi
ma hA	maha
shra ma NaH	shramana
gra ha	graha
nAk+Sha tra	nakshatra
d+h+ya mi	dhyami
ka ra Ni	karani
he he	hé hé
bhan+dha	bhenda
dhA ra ya	dharaya
ni run+dha	nirundha
a mu ka	amuka
ur+Na	urna
tsin+ta	tsinta
dzwa la	dzala
bhur	bhur
ti thi	titi
a ka ni	akani
ni ka ni	nikani
a bhi la	abhila
mang+ha lé	manghalé
maN+Da le	mandalé
saM gha	sangha
saM gha ya	sanghaya
mang+ga la	mangala
bha ba tu	bhavatu
mchod 'os	chö'ö
tsaN+Da lI	tsendali
mi 'dod	mindö
na moH	namo
bzhi bcu	shyibchu
mi 'byung	minjung
lnga bcu	ngabchu
bud+d+ha	buddha
lnga brgya	ngabgya
Da ki nI	dakini
DA ki nI	dakini
shes rig	sherig
tA re	taré
tut+tA re	tuttaré
dz+nyA na	jñana
A yu She	ayukhé
a mA ra Ni	amarani
dzI wan+ti	dziwenti
kro d+ha	krodha
pu n+ye	punyé
A yur	ayur
kI li	kili
kI la ya	kilaya
nr-i	nri
dzaH	dza
pha la	pala
mu ne	muné
d+hu ru	dhuru
sa ma ya	samaya
shAn+tiM	shanting
ku ru	kuru
bo d+hi tsi t+ta	bodhitsitta
bo d+hi tsit+ta	bodhitsitta
su kha	sukha
pany+tsa	pentsa
mu ne ye	muneyé
gu h+ya	guhya
ka ta	kata
kro d+hi	krodhi
shwa rI	shori
ha ri ni sa	harinisa
ra tsa	ratsa
duSh+TaN	dushten
ta ka ha na	takahana
da ha pa tsa	dahapatsa
e dza	edza
yak+sha	yaksha
ma ma	mama
rak+sha	raksha
badz+ra	benza
sar+ba	sarva
hoha	ho
phaiM	pem
h+ya wa data	hyavadat
te ShAny+tsa	teshan tsa
ni ro d+ha	nirodha
ar+g+haM	argham
pAd+yaM	padam
pUSh+pe	pupé
puSh+pe	pupé
d+hUpe	dhupé
A lo ke	aloké
gan+d+he	gandhé
nai wa d+ya	nevidé
shap+ta	shabta
pra tI ts+tsha ya	pratitsaya
satwa	sato
ma nu	manu
pA la ya	palaya
te no pa	tenopa
ti Sh+tha	tishta
dri D+h+ro	dridho
b+ha wa	bhava
me	mé
su to Sh+yo	sutokhayo
su po Sh+yo	supokhayo
a nu rak+to	anurakto
m+me	mé
pra yats+tsha	prayatsa
kar+ma	karma
su tsa	sutsa
tsit+taM	tsittam
shre yaM	shreyang
b+ha ga wAn	bhagavan
muny+tsa	muntsa
pad+mI	pemi
he tun+te ShAn+ta tha ga to	hetun teshan tatagato
he tun+te ShAn+ta thA ga to	hetun teshan tatagato
d+hartu	dhatu
rang rig	rangrig
'dod pa'am	döpa'am
bcom ldan 'das ma	chomden dema
mkha' 'gro ma	khandroma
dang bcas pa	dang chepa
kha T+wAM ka	khatamka
kha T+wAM	khatam
rgyas 'debs	gyendeb
bai DUr+ya	baidurya
shAkya	shakya
rin po che	rinpoche
mi 'gag	mingak
b+ha ga wa ti	bhagavati
pradzanyA	prajña
hri da ya	hridaya
pA ra mi tA	paramita
pradzanyA pA ra mi tA	prajñaparamita
dwa ti'i bu	datibu
seng nge	sengé
swa b+hA wa	sobhava
haM	hang
tor ya	torya
u Ta	uta
mi Ta ya	mitaya
mon Ta	mönta
kro ta ya	krotaya
a ko	ako
a b+hu	abhu
sha ta ya	shataya
e ling	eling
e Ta ya	etaya
la mon	lamön
Ta ya	taya
as ni	eni
pis ni	pini
b+hur kur	bhurkur
pra Na ye	pranayé
b+hur tsi	bhurtsi
b+hur ku	bhurku
bi ma le	bimalé
u tsuSh+ma	utsushma
tad+ya tha	teyata
ga te	gaté
pA ra	para
saM ga te	samgaté
bo d+hi	bodhi
a na le	analé
bi Sha de	bikadé
bai ra	baira
d+ha ri	dhari
ban+d+ha	bendha
Sh+NI Sha	nika
ma thob bar	matob bar
la bar gcod	la barchö
dpal chen por	pal chenpor
lha chen po	lha chenpo
klu chen po	lu chenpo
gza' chen po	za chenpo
e ka tsa Ti	ekadzati
bsam mi khyab	sam mikhyab
ma hA ka la	mahakala
tut+tA ra	tuttara
pad+mas	pemé
traT	tré
a mri ta	amrita
seng ge	sengé
kha bad	khabé
kang+ka	kangka
rgyas 'debs ma	gyendebma
the'u	te'u
lang+ka	langka
rak+Sha	raksha
sA d+hu	sadhu
kA ya	kaya
wak+ka	wakka
g+ha g+ha	ghagha
g+ha tA ya	ghataya
mA ra ya	maraya
duSh+TaM	dushtam
kI lA ya	kilaya
d+ha ro da	dharoda
dz+nyA	jña
a kro te	atroté
ka mud+ga ra	kamud gara
ba liM ta	balingta
rak+ta	rakta
b+han+d+ha	bhenda
sa man+ta	samenta
mu khe b+h+ya	mukhebé
rde'u	de'u
yum chen mo	yum chenmo
kha na ma tho	khana mato
kha mun+t+ra	khamuntra
duSh+tan	dushten
pa tsa ra Na	patsarana
Dak+ki ni	dakini
ma hA kA li	mahakali
man+dA ra	mendara
ru tra	rudra
gtsug lag khang	tsuklakhang
yang le ber	yanglé wer
tsi'u dmar po	tsiu marpo
kyai	kyé
sangs rgyas pa	sangyé pa
kun tu bzang mo	kuntuzangmo
